5*%x
*****
**%**
*****
*%***
*****
