10*%x
**%*****%*
***%%%****
**********
**%***%*%*
%****%****
%*%***%***
**********
*******%**
**********
**********
