10?*:%
2222222222
2222222212
2212222222
2222212222
1212212122
1122122122
1212122122
1222212212
2222122112
122222222
